K>> d.DM(1:20,:)   

ans =

     1     0     0     0     0     0
     0     1     0     0     0     0
     0     0     1     0     0     0
     0     0     1     0     0     0
     0     0     0     0     0     0
     0     0     0     0     0     0
     0     0     0     0     0     0
     0     0     0     0     0     0
     0     0     0     0     0     0
     0     0     0     0     0     0
     0     0     0     0     0     0
     0     0     0     0     0     0
     1     0     1     0     0     0
     0     0     1     0     0     0
     0     0     0     0     0     0
     0     0     0     0     0     0
     0     0     0     0     0     0
     0     0     0     0     0     0
     0     0     0     0     0     0
     0     0     0     0     0     0

K>> trialStarts(1:5)

ans =

     1
    13
    23
    40
    70

K>> trialEnds(1:5)  

ans =

     3
    13
    30
    43
    73

K>> tempEnds(1:5)

ans =

     3
     4
    13
    14
    30

